(supertux-level
  (version 3)
  (name (_ "Oh Snow"))
  (author "Sophie \"Vaesea\" Ball")
  (license "CC-BY-SA 4.0 International")
  (target-time 34)
  (sector
    (name "main")
    (ambient-light
      (color 0.6 0.6 0.6)
    )
    (camera
      (name "Camera")
      (mode "normal")
    )
    (music
      (file "/music/bossattack.music")
    )
    (spawnpoint
      (name "main")
      (x 736)
      (y 864)
    )
    (tilemap
      (solid #f)
      (z-pos -100)
      (width 47)
      (height 35)
      (tiles
      0 0 0 0 0 0 0 0 0 0 0 0 0 0 0 0 0 0 0 0 0 0 0 0 0 0 0 0 0 0 0 0 0 0 0 0 0 0 0 0 0 0 0 0 0 0 0
      0 0 0 0 0 0 0 0 0 0 0 0 0 0 0 0 0 0 0 0 0 0 0 0 0 0 0 0 0 0 0 0 0 0 0 0 0 0 0 0 0 0 0 0 0 0 0
      0 0 0 0 0 0 0 0 0 0 0 0 0 0 0 0 0 0 0 0 0 0 0 0 0 0 0 0 0 0 0 0 0 0 0 0 0 0 0 0 0 0 0 0 0 0 0
      0 0 0 0 0 0 0 0 0 0 0 0 0 0 0 0 0 0 0 0 0 0 0 0 0 0 0 0 0 0 0 0 0 0 0 0 0 0 0 0 0 0 0 0 0 0 0
      0 0 0 0 0 0 0 0 0 0 0 0 0 0 0 0 0 0 0 0 0 0 0 0 0 0 0 0 0 0 0 0 0 0 0 0 0 0 0 0 0 0 0 0 0 0 0
      0 0 0 0 0 0 0 0 0 0 0 0 0 0 0 0 0 0 0 0 0 0 0 0 0 0 0 0 0 0 0 0 0 0 0 0 0 0 0 0 0 0 0 0 0 0 0
      0 0 0 0 0 0 0 0 0 0 0 0 0 0 0 0 0 0 0 0 0 0 0 0 0 0 0 0 0 0 0 0 0 0 0 0 0 0 0 0 0 0 0 0 0 0 0
      0 0 0 0 0 0 0 0 0 0 0 0 0 0 0 0 0 0 0 0 0 0 0 0 0 0 0 0 0 0 0 0 0 0 0 0 0 0 0 0 0 0 0 0 0 0 0
      0 0 0 0 0 0 0 0 0 0 0 0 0 0 0 0 0 0 0 0 0 0 0 0 0 0 0 0 0 0 0 0 0 0 0 0 0 0 0 0 0 0 0 0 0 0 0
      0 0 0 0 0 0 0 0 0 0 0 0 0 0 0 0 0 0 0 0 0 0 0 0 0 0 0 0 0 0 0 0 0 0 0 0 0 0 0 0 0 0 0 0 0 0 0
      0 0 0 0 0 0 0 0 0 0 0 0 0 0 0 0 0 0 0 0 0 0 0 0 0 0 0 0 0 0 0 0 0 0 0 0 0 0 0 0 0 0 0 0 0 0 0
      0 0 0 0 0 0 0 0 0 0 0 0 0 0 0 0 0 0 0 0 0 0 0 0 0 0 0 0 0 0 0 0 0 0 0 0 0 0 0 0 0 0 0 0 0 0 0
      0 0 0 0 0 0 0 0 0 0 0 0 0 0 0 0 0 0 0 0 0 0 0 0 0 0 0 0 0 0 0 0 0 0 0 0 0 0 0 0 0 0 0 0 0 0 0
      0 0 0 0 0 0 0 0 0 0 0 0 0 0 0 0 0 0 0 0 0 0 0 0 0 0 0 0 0 0 0 0 0 0 0 0 0 0 0 0 0 0 0 0 0 0 0
      0 0 0 0 0 0 0 0 0 0 0 0 0 0 0 0 0 0 0 0 0 0 0 0 0 0 0 0 0 0 0 0 0 0 0 0 0 0 0 0 0 0 0 0 0 0 0
      0 0 0 0 0 0 0 0 0 0 0 0 0 0 0 0 0 0 0 0 0 0 0 0 0 0 0 0 0 0 0 0 0 0 0 0 0 0 0 0 0 0 0 0 0 0 0
      0 0 0 0 0 0 0 0 0 0 0 0 0 0 0 0 0 0 0 0 0 0 0 0 0 0 0 0 0 0 0 0 0 0 0 0 0 0 0 0 0 0 0 0 0 0 0
      0 0 0 0 0 0 0 0 0 0 0 0 0 0 0 0 0 0 0 0 0 0 0 0 0 0 0 0 0 0 0 0 0 0 0 0 0 0 0 0 0 0 0 0 0 0 0
      0 0 0 0 0 0 0 0 0 0 0 0 0 0 0 0 0 0 0 0 0 0 0 0 0 0 0 0 0 0 0 0 0 0 0 0 0 0 0 0 0 0 0 0 0 0 0
      0 0 0 0 0 0 0 0 0 0 0 0 0 0 0 0 0 0 0 0 0 0 0 0 0 0 0 0 0 0 0 0 0 0 0 0 0 0 0 0 0 0 0 0 0 0 0
      0 106 107 108 0 0 0 0 0 0 0 0 0 0 0 0 0 0 0 0 0 0 0 0 0 0 0 0 0 0 0 0 0 0 0 0 0 0 0 0 0 0 0 0 0 0 106
      0 109 110 111 0 24 0 25 0 0 0 0 0 0 0 0 0 0 0 0 0 0 0 0 0 0 0 0 0 0 0 0 0 0 0 0 0 0 0 25 0 0 0 24 0 0 109
      0 0 0 0 0 0 0 0 0 0 0 0 0 0 0 0 0 0 0 0 0 0 0 0 0 0 0 0 0 0 0 0 0 0 0 0 0 0 0 0 0 0 0 0 0 0 0
      0 0 0 0 0 0 0 0 0 0 0 0 0 0 0 0 0 0 0 0 0 0 0 0 0 0 0 0 0 0 0 0 0 0 0 0 0 0 0 0 0 0 0 0 0 0 0
      0 0 0 0 0 0 0 0 0 0 0 0 0 0 0 0 0 0 0 0 0 0 0 0 0 0 0 0 0 0 0 0 0 0 0 0 0 0 0 0 0 0 0 0 0 0 0
      0 0 0 0 0 0 0 0 0 0 0 0 0 0 0 0 0 0 0 0 0 0 0 0 0 0 0 0 0 0 0 0 0 0 0 0 0 0 0 0 0 0 0 0 0 0 0
      0 0 0 0 0 0 0 0 0 0 0 0 0 0 0 0 0 0 0 0 0 0 0 0 0 0 0 0 0 0 0 0 0 0 0 0 0 0 0 0 0 0 0 0 0 0 0
      0 0 0 0 0 0 0 0 0 0 0 0 0 0 0 0 0 0 0 0 0 0 0 0 0 0 0 0 0 0 106 107 108 0 0 0 0 0 0 0 0 0 0 0 0 0 0
      0 0 0 0 0 0 0 0 0 0 0 0 0 0 24 0 0 0 25 25 0 0 0 25 0 0 0 24 0 0 109 110 111 0 0 0 0 0 0 0 0 0 0 0 0 0 0
      0 0 0 0 0 0 0 0 0 0 0 0 0 0 0 0 0 0 0 0 0 0 0 0 0 0 0 0 0 0 0 0 0 0 0 0 0 0 0 0 0 0 0 0 0 0 0
      0 0 0 0 0 0 0 0 0 0 0 0 0 0 0 0 0 0 0 0 0 0 0 0 0 0 0 0 0 0 0 0 0 0 0 0 0 0 0 0 0 0 0 0 0 0 0
      0 0 0 0 0 0 0 0 0 0 0 0 0 0 0 0 0 0 0 0 0 0 0 0 0 0 0 0 0 0 0 0 0 0 0 0 0 0 0 0 0 0 0 0 0 0 0
      0 0 0 0 0 0 0 0 0 0 0 0 0 0 0 0 0 0 0 0 0 0 0 0 0 0 0 0 0 0 0 0 0 0 0 0 0 0 0 0 0 0 0 0 0 0 0
      0 0 0 0 0 0 0 0 0 0 0 0 0 0 0 0 0 0 0 0 0 0 0 0 0 0 0 0 0 0 0 0 0 0 0 0 0 0 0 0 0 0 0 0 0 0 0
      0 0 0 0 0 0 0 0 0 0 0 0 0 0 0 0 0 0 0 0 0 0 0 0 0 0 0 0 0 0 0 0 0 0 0 0 0 0 0 0 0 0 0 0 0 0 0
      )
    )
    (tilemap
      (solid #f)
      (z-pos 100)
      (width 47)
      (height 35)
      (tiles
      0 0 0 0 0 0 0 0 0 0 0 0 0 0 0 0 0 0 0 0 0 0 0 0 0 0 0 0 0 0 0 0 0 0 0 0 0 0 0 0 0 0 0 0 0 0 0
      0 0 0 0 0 0 0 0 0 0 0 0 0 0 0 0 0 0 0 0 0 0 0 0 0 0 0 0 0 0 0 0 0 0 0 0 0 0 0 0 0 0 0 0 0 0 0
      0 0 0 0 0 0 0 0 0 0 0 0 0 0 0 0 0 0 0 0 0 0 0 0 0 0 0 0 0 0 0 0 0 0 0 0 0 0 0 0 0 0 0 0 0 0 0
      0 0 0 0 0 0 0 0 0 0 0 0 0 0 0 0 0 0 0 0 0 0 0 0 0 0 0 0 0 0 0 0 0 0 0 0 0 0 0 0 0 0 0 0 0 0 0
      0 0 0 0 0 0 0 0 0 0 0 0 0 0 0 0 0 0 0 0 0 0 0 0 0 0 0 0 0 0 0 0 0 0 0 0 0 0 0 0 0 0 0 0 0 0 0
      0 0 0 0 0 0 0 0 0 0 0 0 0 0 0 0 0 0 0 0 0 0 0 0 0 0 0 0 0 0 0 0 0 0 0 0 0 0 0 0 0 0 0 0 0 0 0
      0 0 0 0 0 0 0 0 0 0 0 0 0 0 0 0 0 0 0 0 0 0 0 0 0 0 0 0 0 0 0 0 0 0 0 0 0 0 0 0 0 0 0 0 0 0 0
      0 0 0 0 0 0 0 0 0 0 0 0 0 0 0 0 0 0 0 0 0 0 0 0 0 0 0 0 0 0 0 0 0 0 0 0 0 0 0 0 0 0 0 0 0 0 0
      0 0 0 0 0 0 0 0 0 0 0 0 0 0 0 0 0 0 0 0 0 0 0 0 0 0 0 0 0 0 0 0 0 0 0 0 0 0 0 0 0 0 0 0 0 0 0
      0 0 0 0 0 0 0 0 0 0 0 0 0 0 0 0 0 0 0 0 0 0 0 0 0 0 0 0 0 0 0 0 0 0 0 0 0 0 0 0 0 0 0 0 0 0 0
      0 0 0 0 0 0 0 0 0 0 0 0 0 0 0 0 0 0 0 0 0 0 0 0 0 0 0 0 0 0 0 0 0 0 0 0 0 0 0 0 0 0 0 0 0 0 0
      0 0 0 0 0 0 0 0 0 0 0 0 0 0 0 0 0 0 0 0 0 0 0 0 0 0 0 0 0 0 0 0 0 0 0 0 0 0 0 0 0 0 0 0 0 0 0
      0 0 0 0 0 0 0 0 0 0 0 0 0 0 0 0 0 0 0 0 0 0 0 0 0 0 0 0 0 0 0 0 0 0 0 0 0 0 0 0 0 0 0 0 0 0 0
      0 0 0 0 0 0 0 0 0 0 0 0 0 0 0 0 0 0 0 0 0 0 0 0 0 0 0 0 0 0 0 0 0 0 0 0 0 0 0 0 0 0 0 0 0 0 0
      0 0 0 0 0 0 0 0 0 0 0 0 0 0 0 0 0 0 0 0 0 0 0 0 0 0 0 0 0 0 0 0 0 0 0 0 0 0 0 0 0 0 0 0 0 0 0
      0 0 0 0 0 0 0 0 0 0 0 0 0 0 0 0 0 0 0 0 0 0 0 0 0 0 0 0 0 0 0 0 0 0 0 0 0 0 0 0 0 0 0 0 0 0 0
      0 0 0 0 0 0 0 0 0 0 0 0 0 0 0 0 0 0 0 0 0 0 0 0 0 0 0 0 0 0 0 0 0 0 0 0 0 0 0 0 0 0 0 0 0 0 0
      0 0 0 0 0 0 0 0 0 0 0 0 0 0 0 0 0 0 0 0 0 0 0 0 0 0 0 0 0 0 0 0 0 0 0 0 0 0 0 0 0 0 0 0 0 0 0
      0 0 0 0 0 0 0 0 0 0 0 0 0 0 0 0 0 0 0 0 0 0 0 0 0 0 0 0 0 0 0 0 0 0 0 0 0 0 0 0 0 0 0 0 0 0 0
      0 0 0 0 0 0 0 0 0 0 0 0 0 0 0 0 0 0 0 0 0 0 0 0 0 0 0 0 0 0 0 0 0 0 0 0 0 0 0 0 0 0 0 0 0 0 0
      0 0 0 0 0 0 0 0 0 0 0 0 0 0 0 0 0 0 0 0 0 0 0 0 0 0 0 0 0 0 0 0 0 0 0 0 0 0 0 0 0 0 0 0 0 0 0
      0 0 0 0 0 0 0 0 0 0 0 0 0 0 0 0 0 0 0 0 0 0 0 0 0 0 0 0 0 0 0 0 0 0 0 0 0 0 0 0 0 0 0 0 0 0 0
      0 0 0 0 0 0 0 0 0 0 0 0 0 0 0 0 0 0 0 0 0 0 0 0 0 0 0 0 0 0 0 0 0 0 0 0 0 0 0 0 0 0 0 0 0 0 0
      0 0 0 0 0 0 0 0 0 0 0 0 0 0 0 0 0 0 0 0 0 0 0 0 0 0 0 0 0 0 0 0 0 0 0 0 0 0 0 0 0 0 0 0 0 0 0
      0 0 0 0 0 0 0 0 0 0 0 0 0 0 0 0 0 0 0 0 0 0 0 0 0 0 0 0 0 0 0 0 0 0 0 0 0 0 0 0 0 0 0 0 0 0 0
      0 0 0 0 0 0 0 0 0 0 0 0 0 0 0 0 0 0 0 0 0 0 0 0 0 0 0 0 0 0 0 0 0 0 0 0 0 0 0 0 0 0 0 0 0 0 0
      0 0 0 0 0 0 0 0 0 0 0 0 0 0 0 0 0 0 0 0 0 0 0 0 0 0 0 0 0 0 0 0 0 0 0 0 0 0 0 0 0 0 0 0 0 0 0
      0 0 0 0 0 0 0 0 0 0 0 0 0 0 0 0 0 0 0 0 0 0 0 0 0 0 0 0 0 0 0 0 0 0 0 0 0 0 0 0 0 0 0 0 0 0 0
      0 0 0 0 0 0 0 0 0 0 0 0 0 0 0 0 0 0 0 0 0 0 0 0 0 0 0 0 0 0 0 0 0 0 0 0 0 0 0 0 0 0 0 0 0 0 0
      0 0 0 0 0 0 0 0 0 0 0 0 0 0 0 0 0 0 0 0 0 0 0 0 0 0 0 0 0 0 0 0 0 0 0 0 0 0 0 0 0 0 0 0 0 0 0
      0 0 0 0 0 0 0 0 0 0 0 0 0 0 0 0 0 0 0 0 0 0 0 0 0 0 0 0 0 0 0 0 0 0 0 0 0 0 0 0 0 0 0 0 0 0 0
      0 0 0 0 0 0 0 0 0 0 0 0 0 0 0 0 0 0 0 0 0 0 0 0 0 0 0 0 0 0 0 0 0 0 0 0 0 0 0 0 0 0 0 0 0 0 0
      0 0 0 0 0 0 0 0 0 0 0 0 0 0 0 0 0 0 0 0 0 0 0 0 0 0 0 0 0 0 0 0 0 0 0 0 0 0 0 0 0 0 0 0 0 0 0
      0 0 0 0 0 0 0 0 0 0 0 0 0 0 0 0 0 0 0 0 0 0 0 0 0 0 0 0 0 0 0 0 0 0 0 0 0 0 0 0 0 0 0 0 0 0 0
      0 0 0 0 0 0 0 0 0 0 0 0 0 0 0 0 0 0 0 0 0 0 0 0 0 0 0 0 0 0 0 0 0 0 0 0 0 0 0 0 0 0 0 0 0 0 0
      )
    )
    (tilemap
      (solid #t)
      (z-pos 0)
      (width 47)
      (height 35)
      (tiles
      11 11 11 11 11 11 11 11 11 11 11 11 11 11 11 11 11 11 11 11 11 11 11 11 11 11 11 11 11 11 11 11 11 11 11 11 11 11 11 11 11 11 11 11 11 11 11
      11 11 11 11 11 11 11 11 11 11 11 11 11 11 11 11 11 11 11 11 11 11 11 11 11 11 11 11 11 11 11 11 11 11 11 11 11 11 11 11 11 11 11 11 11 11 11
      11 11 11 11 11 11 11 11 11 11 11 11 11 11 11 11 11 11 11 11 11 11 11 11 11 11 11 11 11 11 11 11 11 11 11 11 11 11 11 11 11 11 11 11 11 11 11
      11 11 11 11 11 11 11 11 11 11 11 11 11 11 11 11 11 11 11 11 11 11 11 11 11 11 11 11 11 11 11 11 11 11 11 11 11 11 11 11 11 11 11 11 11 11 11
      11 11 11 11 11 11 11 11 11 11 11 11 11 11 11 11 11 11 11 11 11 11 11 11 11 11 11 11 11 11 11 11 11 11 11 11 11 11 11 11 11 11 11 11 11 11 11
      11 11 11 11 11 11 11 11 11 11 11 11 11 11 11 11 11 11 11 11 11 11 11 11 11 11 11 11 11 11 11 11 11 11 11 11 11 11 11 11 11 11 11 11 11 11 11
      11 11 11 11 11 11 11 11 11 11 11 11 11 11 11 11 11 11 11 11 11 11 11 11 11 11 11 11 11 11 11 11 11 11 11 11 11 11 11 11 11 11 11 11 11 11 11
      11 11 11 11 11 11 11 11 11 11 11 11 11 11 11 11 11 11 11 11 11 11 11 11 11 11 11 11 11 11 11 11 11 11 11 11 11 11 11 11 11 11 11 11 11 11 11
      11 11 11 11 11 11 11 11 11 11 11 11 11 11 11 11 11 11 11 11 11 11 11 11 11 11 11 11 11 11 11 11 11 11 11 11 11 11 11 11 11 11 11 11 11 11 11
      11 11 11 11 11 11 11 11 11 11 11 11 11 11 11 11 11 11 11 11 11 11 11 11 11 11 11 11 11 11 11 11 11 11 11 11 11 11 11 11 11 11 11 11 11 11 11
      11 11 11 11 11 11 11 11 11 11 11 11 11 11 11 11 11 11 11 11 11 11 11 11 11 11 11 11 11 11 11 11 11 11 11 11 11 11 11 11 11 11 11 11 11 11 11
      11 11 11 11 11 11 11 11 11 11 11 11 11 11 11 11 11 11 11 11 11 11 11 11 11 11 11 11 11 11 11 11 11 11 11 11 11 11 11 11 11 11 11 11 11 11 11
      11 11 11 11 11 11 11 11 11 11 11 11 11 11 11 11 11 11 11 11 11 11 11 11 11 11 11 11 11 11 11 11 11 11 11 11 11 11 11 11 11 11 11 11 11 11 11
      11 11 11 11 11 11 11 11 11 11 11 11 11 11 11 11 11 11 11 11 11 11 11 11 11 11 11 11 11 11 11 11 11 11 11 11 11 11 11 11 11 11 11 11 11 11 11
      11 11 11 11 11 11 11 11 11 11 11 11 11 11 11 11 11 11 11 11 11 11 11 11 11 11 11 11 11 11 11 11 11 11 11 11 11 11 11 11 11 11 11 11 11 11 11
      11 11 11 11 11 11 11 11 11 11 11 11 11 11 11 11 11 11 11 11 11 11 11 11 11 11 11 11 11 11 11 11 11 11 11 11 11 11 11 11 11 11 11 11 11 11 11
      17 17 17 17 17 17 17 17 17 17 17 17 17 17 17 17 17 17 17 17 17 17 17 17 17 17 17 17 17 17 17 17 17 17 17 17 17 17 17 17 17 17 17 17 17 17 17
      0 0 0 0 0 0 0 0 0 0 0 0 0 0 0 0 0 0 0 0 0 0 0 0 0 0 0 0 0 0 0 0 0 0 0 0 0 0 0 0 0 0 0 0 0 0 0
      0 0 0 0 0 0 0 0 0 0 0 0 0 0 0 0 0 0 0 0 0 0 0 0 0 0 0 0 0 0 0 0 0 0 0 0 0 0 0 0 0 0 0 0 0 0 0
      0 0 0 0 0 0 0 0 0 0 0 0 0 0 0 0 0 0 0 0 0 0 0 0 0 0 0 0 0 0 0 0 0 0 0 0 0 0 0 0 0 0 0 0 0 0 0
      0 0 0 0 0 0 0 0 0 0 0 0 0 0 0 0 0 0 0 0 0 0 0 0 0 0 0 0 0 0 0 0 0 0 0 0 0 0 0 0 0 0 0 0 0 0 0
      8 8 8 8 8 8 8 8 8 8 9 0 0 0 0 0 0 0 0 0 0 0 0 0 0 0 0 0 0 0 0 0 0 0 0 0 7 8 8 8 8 8 8 8 8 8 8
      14 14 14 14 14 14 14 14 14 14 15 0 0 0 0 0 0 0 0 0 0 0 0 0 0 0 0 0 0 0 0 0 0 0 0 0 13 14 14 14 14 14 14 14 14 14 14
      11 11 11 11 11 11 11 11 11 11 12 0 0 0 0 0 0 0 0 0 0 0 0 0 0 0 0 0 0 0 0 0 0 0 0 0 10 11 11 11 11 11 11 11 11 11 11
      11 11 11 11 11 11 11 11 11 11 12 0 0 0 0 0 0 0 0 0 0 0 0 0 0 0 0 0 0 0 0 0 0 0 0 0 10 11 11 11 11 11 11 11 11 11 11
      11 11 11 11 11 11 11 11 11 11 12 0 0 0 0 0 0 0 0 0 0 0 0 0 0 0 0 0 0 0 0 0 0 0 0 0 10 11 11 11 11 11 11 11 11 11 11
      11 11 11 11 11 11 11 11 11 11 12 0 0 0 0 0 0 0 0 0 0 0 0 0 0 0 0 0 0 0 0 0 0 0 0 0 10 11 11 11 11 11 11 11 11 11 11
      11 11 11 11 11 11 11 11 11 11 12 0 0 0 0 0 0 0 0 0 0 0 0 0 0 0 0 0 0 0 0 0 0 0 0 0 10 11 11 11 11 11 11 11 11 11 11
      11 11 11 11 11 11 11 11 11 11 21 8 8 8 8 8 8 8 8 8 8 8 8 8 8 8 8 8 8 8 8 8 8 8 8 8 22 11 11 11 11 11 11 11 11 11 11
      11 11 11 11 11 11 11 11 11 11 20 14 14 14 14 14 14 14 14 14 14 14 14 14 14 14 14 14 14 14 14 14 14 14 14 14 23 11 11 11 11 11 11 11 11 11 11
      11 11 11 11 11 11 11 11 11 11 11 11 11 11 11 11 11 11 11 11 11 11 11 11 11 11 11 11 11 11 11 11 11 11 11 11 11 11 11 11 11 11 11 11 11 11 11
      11 11 11 11 11 11 11 11 11 11 11 11 11 11 11 11 11 11 11 11 11 11 11 11 11 11 11 11 11 11 11 11 11 11 11 11 11 11 11 11 11 11 11 11 11 11 11
      11 11 11 11 11 11 11 11 11 11 11 11 11 11 11 11 11 11 11 11 11 11 11 11 11 11 11 11 11 11 11 11 11 11 11 11 11 11 11 11 11 11 11 11 11 11 11
      11 11 11 11 11 11 11 11 11 11 11 11 11 11 11 11 11 11 11 11 11 11 11 11 11 11 11 11 11 11 11 11 11 11 11 11 11 11 11 11 11 11 11 11 11 11 11
      11 11 11 11 11 11 11 11 11 11 11 11 11 11 11 11 11 11 11 11 11 11 11 11 11 11 11 11 11 11 11 11 11 11 11 11 11 11 11 11 11 11 11 11 11 11 11
      )
    )
    (tilemap
      (solid #f)
      (speed-x 0.5)
      (speed-y 0.5)
      (tint 0.5 0.5 0.5)
      (z-pos -200)
      (width 47)
      (height 35)
      (tiles
      2196 2188 2189 2196 2188 2189 2188 2188 2196 2188 2189 2196 2188 2189 2188 2188 2196 2188 2189 2196 2188 2189 2188 2188 2196 2188 2189 2196 2188 2189 2188 2188 2196 2188 2189 2196 2188 2189 2188 2188 2196 2188 2189 2196 2188 2189 2188
      2179 2195 2196 2179 2195 2195 2195 2196 2179 2195 2196 2179 2195 2195 2195 2196 2179 2195 2196 2179 2195 2195 2195 2196 2179 2195 2196 2179 2195 2195 2195 2196 2179 2195 2196 2179 2195 2195 2195 2196 2179 2195 2196 2179 2195 2195 2195
      2188 2196 2188 2188 2189 2196 2189 2188 2188 2196 2188 2188 2189 2196 2189 2188 2188 2196 2188 2188 2189 2196 2189 2188 2188 2196 2188 2188 2189 2196 2189 2188 2188 2196 2188 2188 2189 2196 2189 2188 2188 2196 2188 2188 2189 2196 2189
      2197 2180 2181 2197 2187 2181 2180 2187 2197 2180 2181 2197 2187 2181 2180 2187 2197 2180 2181 2197 2187 2181 2180 2187 2197 2180 2181 2197 2187 2181 2180 2187 2197 2180 2181 2197 2187 2181 2180 2187 2197 2180 2181 2197 2187 2181 2180
      2196 2188 2189 2196 2188 2189 2188 2188 2196 2188 2189 2196 2188 2189 2188 2188 2196 2188 2189 2196 2188 2189 2188 2188 2196 2188 2189 2196 2188 2189 2188 2188 2196 2188 2189 2196 2188 2189 2188 2188 2196 2188 2189 2196 2188 2189 2188
      2179 2195 2196 2179 2195 2195 2195 2196 2179 2195 2196 2179 2195 2195 2195 2196 2179 2195 2196 2179 2195 2195 2195 2196 2179 2195 2196 2179 2195 2195 2195 2196 2179 2195 2196 2179 2195 2195 2195 2196 2179 2195 2196 2179 2195 2195 2195
      2188 2196 2188 2188 2189 2196 2189 2188 2188 2196 2188 2188 2189 2196 2189 2188 2188 2196 2188 2188 2189 2196 2189 2188 2188 2196 2188 2188 2189 2196 2189 2188 2188 2196 2188 2188 2189 2196 2189 2188 2188 2196 2188 2188 2189 2196 2189
      2197 2180 2181 2197 2187 2181 2180 2187 2197 2180 2181 2197 2187 2181 2180 2187 2197 2180 2181 2197 2187 2181 2180 2187 2197 2180 2181 2197 2187 2181 2180 2187 2197 2180 2181 2197 2187 2181 2180 2187 2197 2180 2181 2197 2187 2181 2180
      2196 2188 2189 2196 2188 2189 2188 2188 2196 2188 2189 2196 2188 2189 2188 2188 2196 2188 2189 2196 2188 2189 2188 2188 2196 2188 2189 2196 2188 2189 2188 2188 2196 2188 2189 2196 2188 2189 2188 2188 2196 2188 2189 2196 2188 2189 2188
      2179 2195 2196 2179 2195 2195 2195 2196 2179 2195 2196 2179 2195 2195 2195 2196 2179 2195 2196 2179 2195 2195 2195 2196 2179 2195 2196 2179 2195 2195 2195 2196 2179 2195 2196 2179 2195 2195 2195 2196 2179 2195 2196 2179 2195 2195 2195
      2188 2196 2188 2188 2189 2196 2189 2188 2188 2196 2188 2188 2189 2196 2189 2188 2188 2196 2188 2188 2189 2196 2189 2188 2188 2196 2188 2188 2189 2196 2189 2188 2188 2196 2188 2188 2189 2196 2189 2188 2188 2196 2188 2188 2189 2196 2189
      2197 2180 2181 2197 2187 2181 2180 2187 2197 2180 2181 2197 2187 2181 2180 2187 2197 2180 2181 2197 2187 2181 2180 2187 2197 2180 2181 2197 2187 2181 2180 2187 2197 2180 2181 2197 2187 2181 2180 2187 2197 2180 2181 2197 2187 2181 2180
      2196 2188 2189 2196 2188 2189 2188 2188 2196 2188 2189 2196 2188 2189 2188 2188 2196 2188 2189 2196 2188 2189 2188 2188 2196 2188 2189 2196 2188 2189 2188 2188 2196 2188 2189 2196 2188 2189 2188 2188 2196 2188 2189 2196 2188 2189 2188
      2179 2195 2196 2179 2195 2195 2195 2196 2179 2195 2196 2179 2195 2195 2195 2196 2179 2195 2196 2179 2195 2195 2195 2196 2179 2195 2196 2179 2195 2195 2195 2196 2179 2195 2196 2179 2195 2195 2195 2196 2179 2195 2196 2179 2195 2195 2195
      2188 2196 2188 2188 2189 2196 2189 2188 2188 2196 2188 2188 2189 2196 2189 2188 2188 2196 2188 2188 2189 2196 2189 2188 2188 2196 2188 2188 2189 2196 2189 2188 2188 2196 2188 2188 2189 2196 2189 2188 2188 2196 2188 2188 2189 2196 2189
      2197 2180 2181 2197 2187 2181 2180 2187 2197 2180 2181 2197 2187 2181 2180 2187 2197 2180 2181 2197 2187 2181 2180 2187 2197 2180 2181 2197 2187 2181 2180 2187 2197 2180 2181 2197 2187 2181 2180 2187 2197 2180 2181 2197 2187 2181 2180
      2196 2188 2189 2196 2188 2189 2188 2188 2196 2188 2189 2196 2188 2189 2188 2188 2196 2188 2189 2196 2188 2189 2188 2188 2196 2188 2189 2196 2188 2189 2188 2188 2196 2188 2189 2196 2188 2189 2188 2188 2196 2188 2189 2196 2188 2189 2188
      2179 2195 2196 2179 2195 2195 2195 2196 2179 2195 2196 2179 2195 2195 2195 2196 2179 2195 2196 2179 2195 2195 2195 2196 2179 2195 2196 2179 2195 2195 2195 2196 2179 2195 2196 2179 2195 2195 2195 2196 2179 2195 2196 2179 2195 2195 2195
      2188 2196 2188 2188 2189 2196 2189 2188 2188 2196 2188 2188 2189 2196 2189 2188 2188 2196 2188 2188 2189 2196 2189 2188 2188 2196 2188 2188 2189 2196 2189 2188 2188 2196 2188 2188 2189 2196 2189 2188 2188 2196 2188 2188 2189 2196 2189
      2197 2180 2181 2197 2187 2181 2180 2187 2197 2180 2181 2197 2187 2181 2180 2187 2197 2180 2181 2197 2187 2181 2180 2187 2197 2180 2181 2197 2187 2181 2180 2187 2197 2180 2181 2197 2187 2181 2180 2187 2197 2180 2181 2197 2187 2181 2180
      2196 2188 2189 2196 2188 2189 2188 2188 2196 2188 2189 2196 2188 2189 2188 2188 2196 2188 2189 2196 2188 2189 2188 2188 2196 2188 2189 2196 2188 2189 2188 2188 2196 2188 2189 2196 2188 2189 2188 2188 2196 2188 2189 2196 2188 2189 2188
      2179 2195 2196 2179 2195 2195 2195 2196 2179 2195 2196 2179 2195 2195 2195 2196 2179 2195 2196 2179 2195 2195 2195 2196 2179 2195 2196 2179 2195 2195 2195 2196 2179 2195 2196 2179 2195 2195 2195 2196 2179 2195 2196 2179 2195 2195 2195
      2188 2196 2188 2188 2189 2196 2189 2188 2188 2196 2188 2188 2189 2196 2189 2188 2188 2196 2188 2188 2189 2196 2189 2188 2188 2196 2188 2188 2189 2196 2189 2188 2188 2196 2188 2188 2189 2196 2189 2188 2188 2196 2188 2188 2189 2196 2189
      2197 2180 2181 2197 2187 2181 2180 2187 2197 2180 2181 2197 2187 2181 2180 2187 2197 2180 2181 2197 2187 2181 2180 2187 2197 2180 2181 2197 2187 2181 2180 2187 2197 2180 2181 2197 2187 2181 2180 2187 2197 2180 2181 2197 2187 2181 2180
      2196 2188 2189 2196 2188 2189 2188 2188 2196 2188 2189 2196 2188 2189 2188 2188 2196 2188 2189 2196 2188 2189 2188 2188 2196 2188 2189 2196 2188 2189 2188 2188 2196 2188 2189 2196 2188 2189 2188 2188 2196 2188 2189 2196 2188 2189 2188
      2179 2195 2196 2179 2195 2195 2195 2196 2179 2195 2196 2179 2195 2195 2195 2196 2179 2195 2196 2179 2195 2195 2195 2196 2179 2195 2196 2179 2195 2195 2195 2196 2179 2195 2196 2179 2195 2195 2195 2196 2179 2195 2196 2179 2195 2195 2195
      2188 2196 2188 2188 2189 2196 2189 2188 2188 2196 2188 2188 2189 2196 2189 2188 2188 2196 2188 2188 2189 2196 2189 2188 2188 2196 2188 2188 2189 2196 2189 2188 2188 2196 2188 2188 2189 2196 2189 2188 2188 2196 2188 2188 2189 2196 2189
      2197 2180 2181 2197 2187 2181 2180 2187 2197 2180 2181 2197 2187 2181 2180 2187 2197 2180 2181 2197 2187 2181 2180 2187 2197 2180 2181 2197 2187 2181 2180 2187 2197 2180 2181 2197 2187 2181 2180 2187 2197 2180 2181 2197 2187 2181 2180
      2196 2188 2189 2196 2188 2189 2188 2188 2196 2188 2189 2196 2188 2189 2188 2188 2196 2188 2189 2196 2188 2189 2188 2188 2196 2188 2189 2196 2188 2189 2188 2188 2196 2188 2189 2196 2188 2189 2188 2188 2196 2188 2189 2196 2188 2189 2188
      2179 2195 2196 2179 2195 2195 2195 2196 2179 2195 2196 2179 2195 2195 2195 2196 2179 2195 2196 2179 2195 2195 2195 2196 2179 2195 2196 2179 2195 2195 2195 2196 2179 2195 2196 2179 2195 2195 2195 2196 2179 2195 2196 2179 2195 2195 2195
      2188 2196 2188 2188 2189 2196 2189 2188 2188 2196 2188 2188 2189 2196 2189 2188 2188 2196 2188 2188 2189 2196 2189 2188 2188 2196 2188 2188 2189 2196 2189 2188 2188 2196 2188 2188 2189 2196 2189 2188 2188 2196 2188 2188 2189 2196 2189
      2197 2180 2181 2197 2187 2181 2180 2187 2197 2180 2181 2197 2187 2181 2180 2187 2197 2180 2181 2197 2187 2181 2180 2187 2197 2180 2181 2197 2187 2181 2180 2187 2197 2180 2181 2197 2187 2181 2180 2187 2197 2180 2181 2197 2187 2181 2180
      2197 2180 2181 2197 2187 2181 2180 2187 2197 2180 2181 2197 2187 2181 2180 2187 2197 2180 2181 2197 2187 2181 2180 2187 2197 2180 2181 2197 2187 2181 2180 2187 2197 2180 2181 2197 2187 2181 2180 2187 2197 2180 2181 2197 2187 2181 2180
      2196 2188 2189 2196 2188 2189 2188 2188 2196 2188 2189 2196 2188 2189 2188 2188 2196 2188 2189 2196 2188 2189 2188 2188 2196 2188 2189 2196 2188 2189 2188 2188 2196 2188 2189 2196 2188 2189 2188 2188 2196 2188 2189 2196 2188 2189 2188
      2179 2195 2196 2179 2195 2195 2195 2196 2179 2195 2196 2179 2195 2195 2195 2196 2179 2195 2196 2179 2195 2195 2195 2196 2179 2195 2196 2179 2195 2195 2195 2196 2179 2195 2196 2179 2195 2195 2195 2196 2179 2195 2196 2179 2195 2195 2195
      )
    )
    (torch
      (x 320)
      (y 608)
    )
    (torch
      (sprite "/images/objects/torch/torch2.sprite")
      (x 1152)
      (y 608)
    )
    (yeti
      (dead-script "Tux.trigger_sequence(\"fireworks\");")
      (direction "left")
      (x 192)
      (y 608)
    )
    (yeti_stalactite
      (direction "left")
      (x 896)
      (y 512)
    )
    (yeti_stalactite
      (direction "left")
      (x 864)
      (y 512)
    )
    (yeti_stalactite
      (direction "left")
      (x 832)
      (y 512)
    )
    (yeti_stalactite
      (direction "left")
      (x 800)
      (y 512)
    )
    (yeti_stalactite
      (direction "left")
      (x 768)
      (y 512)
    )
    (yeti_stalactite
      (direction "left")
      (x 736)
      (y 512)
    )
    (yeti_stalactite
      (direction "left")
      (x 704)
      (y 512)
    )
    (yeti_stalactite
      (direction "left")
      (x 672)
      (y 512)
    )
    (yeti_stalactite
      (direction "left")
      (x 640)
      (y 512)
    )
    (yeti_stalactite
      (direction "left")
      (x 608)
      (y 512)
    )
    (yeti_stalactite
      (direction "left")
      (x 576)
      (y 512)
    )
    (yeti_stalactite
      (direction "left")
      (x 544)
      (y 512)
    )
    (yeti_stalactite
      (direction "left")
      (x 512)
      (y 512)
    )
    (yeti_stalactite
      (direction "left")
      (x 480)
      (y 512)
    )
    (yeti_stalactite
      (direction "left")
      (x 448)
      (y 512)
    )
    (yeti_stalactite
      (direction "left")
      (x 416)
      (y 512)
    )
    (yeti_stalactite
      (direction "left")
      (x 384)
      (y 512)
    )
    (yeti_stalactite
      (direction "left")
      (x 352)
      (y 512)
    )
    (yeti_stalactite
      (direction "left")
      (x 320)
      (y 512)
    )
    (yeti_stalactite
      (direction "left")
      (x 288)
      (y 512)
    )
    (yeti_stalactite
      (direction "left")
      (x 256)
      (y 512)
    )
    (yeti_stalactite
      (direction "left")
      (x 192)
      (y 512)
    )
    (yeti_stalactite
      (direction "left")
      (x 224)
      (y 512)
    )
    (yeti_stalactite
      (direction "left")
      (x 160)
      (y 512)
    )
    (yeti_stalactite
      (direction "left")
      (x 128)
      (y 512)
    )
    (yeti_stalactite
      (direction "left")
      (x 96)
      (y 512)
    )
    (yeti_stalactite
      (direction "left")
      (x 32)
      (y 512)
    )
    (yeti_stalactite
      (direction "left")
      (x 0)
      (y 512)
    )
    (yeti_stalactite
      (direction "left")
      (x 64)
      (y 512)
    )
    (yeti_stalactite
      (direction "left")
      (x 928)
      (y 512)
    )
    (yeti_stalactite
      (direction "left")
      (x 960)
      (y 512)
    )
    (yeti_stalactite
      (direction "left")
      (x 992)
      (y 512)
    )
    (yeti_stalactite
      (direction "left")
      (x 1024)
      (y 512)
    )
    (yeti_stalactite
      (direction "left")
      (x 1056)
      (y 512)
    )
    (yeti_stalactite
      (direction "left")
      (x 1088)
      (y 512)
    )
    (yeti_stalactite
      (direction "left")
      (x 1120)
      (y 512)
    )
    (yeti_stalactite
      (direction "left")
      (x 1152)
      (y 512)
    )
    (yeti_stalactite
      (direction "left")
      (x 1184)
      (y 512)
    )
    (yeti_stalactite
      (direction "left")
      (x 1216)
      (y 512)
    )
    (yeti_stalactite
      (direction "left")
      (x 1248)
      (y 512)
    )
    (yeti_stalactite
      (direction "left")
      (x 1280)
      (y 512)
    )
    (yeti_stalactite
      (direction "left")
      (x 1312)
      (y 512)
    )
    (yeti_stalactite
      (direction "left")
      (x 1344)
      (y 512)
    )
    (yeti_stalactite
      (direction "left")
      (x 1376)
      (y 512)
    )
    (yeti_stalactite
      (direction "left")
      (x 1408)
      (y 512)
    )
    (yeti_stalactite
      (direction "left")
      (x 1440)
      (y 512)
    )
    (yeti_stalactite
      (direction "left")
      (x 1472)
      (y 512)
    )
  )
)
